11111111111111111111111111111111111111111111111111111111
10000000000000000000000000000000000000000000000000000001
10000000000000000000000000001111111111111100000000000001
10000000000000000000000000000000001000000000000000000001
10000000111110000000000000000000001000000000000000000001
10000000000011111111111000000001111111100000000000000001
10000000000000000010000000000000001000000000001000000001
10000000000000000010000000000000000000000011111000000001
10000000000000000010000000000000000000000000001000000001
10000000000000000010000000000000001000000000001000000001
10000000000000000010000000011111111110000000001000000001
10000000000000000000000000000000001000000000000000000001
10000000000000000000000000000000001111111100000000000001
10000001111111111000000001000000000000000000000000000001
10000001111111111000000000100000000000000000000000000001
10000001111111111000000000010000000000000000111111100001
10000000000000000000000000001000000000000000000000100001
10000000000000000000000000000100000000000000000000100001
10000000000000011111111110000000011111111110000001110001
10000000000000000000000000000000000000000000000000000001
10001100000000000000011111111101000000000001111100000001
10001100001000100000010000000000100000000100000001000001
10001100001000100000010000000000010000000010000010000001
10001100001000111111110001111100001000000001000100000001
10001100001000000000000001000010010000000000101000000001
10001100001000000000000001000001100000000000010000000001
10000000001111111111111111000000000011111111000000000001
10000000000000000000000000000000000100000000100000000001
10000000000000000000000000000000000000000000000000000001
10000000000000000000000000000000000000000000000000000001
11111111111111111111111111111111111111111111111111111111