11111111111111111111111111111111111111111111111111111111
10000000000000000000000000000000000000000000000000000001
10000000000000000000000000001111111111111100000000000001
10000000000000000000000000000000001000000000000000000001
10000000111110000000000000000000001000000000000000000001
10000000000011111111111000000001111111100000000000000001
10000000000000000010000000000000001000000000000000000001
10000000000000000010000000000000001000000000000000000001
10000000000000000010000000000000000000000000000000000001
10000000000000000010000000000000001000000000000000000001
10000000000000000010000000011111111110000000000000000001
10000000000000000000000000000000001000000000000000000001
10000000000000000000000000000000001111111100000000000001
10000000000000000000000000000000000000000000000000000001
10000000000000000000000000000000000000000000000000000001
10000000000000000000000000000000000000000000000000000001
10000000000000000000000000000000000000000000000000000001
10000000000000000000000000000000000000000000000000000001
10000000000000000000000000000000000000000000000000000001
10000000000000000000000000000000000000000000000000000001
10000000000000000000000000000000000000000000000000000001
10000000000000000000000000000000000000000000000000000001
10000000000000000000000000000000000000000000000000000001
10000000000000000000000000000000000000000000000000000001
10000000000000000000000000000000000000000000000000000001
10000000000000000000000000000000000000000000000000000001
10000000000000000000000000000000000000000000000000000001
10000000000000000000000000000000000000000000000000000001
10000000000000000000000000000000000000000000000000000001
10000000000000000000000000000000000000000000000000000001
11111111111111111111111111111111111111111111111111111111